1111111111111111111111111111111111111111111111111111
1000100011000000000000100000010000000000001100010001
1000100011000000000000100000010000000000001100010001
1111100011000000000000000000000000000000001100011111
1000000011000000000000000000000000000000001100000001
1000000011000000000000001111000000000000001100000001
1000000011000000000000001001000000000000001100000001
1000000000000000000111111001111110000000000000000001
1000000000000000000100000000000010000000000000000001
1000000000000000000111111001111110000000000000000001
1000011111000000000000001001000000000000001111100001
1000010001000000000000001001000000000000001000100001
1000010001000000000000001001000000000000001000100001
1000010001000008000000001001000000009000001000100001
1000011111000000011111111001111111100000001111100001
1000000000000000010000000000000000100000000000000001
1000000000000000010111111111111110100000000000000001
1000000000000000010100000000000010100000000000000001
1000000000000111110100000000000010111110000000000001
1000000000000100000100000000000010000010000000000001
1000000000000101111100000000000011111010000000000001
1011111111111101000000000000000000001011111111111101
1010000000000001000000000000000000001000000000000101
1011111111111111000000000000000000001111111111111101
1000000000000000000000000000000000000000000000000001
1000000000000000000000000000000000000000000000000001
1000000000000000000000000000000000000000000000000001
1000000000000000000000000000000000000000000000000001
1000000000000000000000000000000000000000000000000001
1000000000000000000000000000000000000000000000000001
1000000000000000000000000000000000000000000000000001
1111111111111111111111111111111111111111111111111111