1111111111111111111111111111111111111111111111111111
1000000000000000000000010000000000000000000100000001
1000000000000000000000010000000000000000000100000001
1000000000000000000000010000000000000000000100000001
1000000000000000000000010000000000000000000100000001
1000000000000000000000010000000000000000000100000001
1000000000000000000000000000000000000000000000000001
1000000000000000000000000000000000000000000000000001
1000000000000000000000000000000000000000000000000001
1000000000000000000000000000000000000000000000000001
1000000000000000000000000000000000000000000000000001
1000000000000000000000000000000000000000000000000001
1000000000000000000100000000000000000000000000000001
1000000000000000000100000000000000000000000000000001
1000000000000000080100000000000000000000000000000001
1000000000000000000100000000000000000000000000000001
1111110011111001111100011100000000000000000000000001
1000000000000000000000000011100011111001111100111111
1000000000000000000000000000000010000000000000000001
1000000000000000000000000000000010900000000000000001
1000000000000000000000000000000010000000000000000001
1000000000000000000000000000000010000000000000000001
1000000000000000000000000000000000000000000000000001
1000000000000000000000000000000000000000000000000001
1000000000000000000000000000000000000000000000000001
1000000000000000000000000000000000000000000000000001
1000000010000000000000000000100000000000000000000001
1000000010000000000000000000100000000000000000000001
1000000010000000000000000000100000000000000000000001
1000000010000000000000000000100000000000000000000001
1000000010000000000000000000100000000000000000000001
1111111111111111111111111111111111111111111111111111
