1111111111111111111111111111111111111111111111111111
1111111111110000000000000000000000000000000000001111
1100000000000000000000000000000000000000000000001011
1100000000000000000000000000000000000000000000001111
1100000000000000000000000000000000000000000000001001
1100000000000000000000000000000000000000000000001001
1000000000000000000000000001111111111111000000001001
1000000000000000000000000001000000000001000000000001
1000000000000000000000000001011110111101000000000001
1000000000001111111111110001010010100101000000000001
1000000000001000000000010001010010100101000900100111
1000000000001011111111110001010010100101000000010111
1110010000001010000000000001010010100101000000001111
1110100000001011111100000001010010100101000000000111
1111000000001000000100000001010010100101000000000111
1110000000001111110100000001010010100101000000000111
1110000000000000010100000001010010100101000000000111
1110000000000011110100000001110011100111000000000111
1110100000111110000100000000000000000000000000010111
1000000000100000000100000000000000000000000000000001
1000000000111111111100000000000000000000000000000001
1000000000000000000000000000000000000000000000000001
1000000000000000000000000000000000000000000000000001
1000000000000000000000000000000000000000000000000001
1111100000000000800000000110000000000000000000000001
1000100000000000000000000110000000000000000000000001
1010100000000000000000000110000000000001111111111111
1000100000000000000000000110000000000001111111111111
1011100000000000000000000110000000000000000000000111
1010000000000000000000000111111111000000000000000111
1010000000000000000000000111111111000000000000000111
1111111111111111111111111111111111111111111111111111